                                                                                                                       
                                                                                                                        
                                                                                                                        
                                                %%%%                                                                  %%%%                                                                            %%%%                                                 %%%%                                                                  %%%%                                                         $                                                                   %%%%                                                                  %%%%                                                                            %%%%
                %%%%                                                                                       %%%%                                                                             %%%%                 %%%%                                                                                       %%%%                                                                             %%%%                                                                                                       %%%%                                                 $                                %%%%
                                      %%%%                                                        %%%%                                                                           %%%%                                      %%%%                                                        %%%%                                                                           %%%%                                      %%%%                                                        %%%%                                                                           %%%%                                                                               
                                                                       %%%%                                                         %%%%                                                                                             %%%%                            %%%%                                                                                                    %%%%                                                                                                                         %%%%                                                                                                      $                                                                                             %%%%
        %%%%               %%%%                                                     %%%%                            %%%%                                   %%%%                                         %%%%                   %%%%         %%%%               %%%%                                                     %%%%                            %%%%                                   %%%%                                         %%%%                   %%%%         %%%%               %%%%                                                     %%%%                            %%%%                                   %%%%                                         %%%%                   %%%%            
P                                                                                      &                      $                               &                                                                                                                                                                                                                                                                                                                                                                                                                                                                                                                                                                                          *
###############################################################################################################################################################################################################################################################################################################################################################################################################################################################################################################################################################################################################################################################################################################################################