                                                                                                                       
                                                                                                                        
                                                                                                                        
                                                %%%%                                                                  %%%%                                                                            %%%%                                                 %%%%                                                                  %%%%                                                                                  %%%%                                                %%%%                                                                  %%%%                                                                            %%%%
                %%%%                                                                                       %%%%                                                                             %%%%                 %%%%                                                                                       %%%%                                                                             %%%%                $                                                                                       %%%%                                                                             %%%%
                                      %%%%                                                        %%%%                                                                           %%%%                                      %%%%                                                        %%%%                                                                           %%%%                                      %%%%                                                        %%%%                                                                      %%%%                                                                               
                            %%%%                                           %%%%                                                         %%%%                                                                                             %%%%                            %%%%                                             $                                                       %%%%                                                                                                                         %%%%                                                                                                    %%%%                                                     $                                        %%%%
        %%%%               %%%%                                                     %%%%                            %%%%                                   %%%%                                         %%%%                   %%%%         %%%%               %%%%                                                     %%%%                            %%%%                                   %%%%                                         %%%%                   %%%%         %%%%               %%%%                                                     %%%%                            %%%%                                   %%%%                                         %%%%                   %%%%            
P                                                                                      &                      $                               &            $                                                                                                                                                                                                                                                                                                                                                                                                                                                                                                                                                                               *
###############################################################################################################################################################################################################################################################################################################################################################################################################################################################################################################################################################################################################################################################################################################################################