                                                                                                                       
                                                                                                                        
                                                                                                                                                                                                                                                              $                                                                                                                                                                                                                                                                                                                                                                     $                                                                                                            
                                                %%%%                                                        $          %%%%                                                                            %%%%                                                 %%%%                                                                  %%%%                                                                                  %%%%                                                %%%%                                                                  %%%%                                                                            %%%%
                %%%%                                                                                       %%%%                                                                   $          %%%%                 %%%%                                                                                       %%%%                                                                             %%%%                $                                                                                       %%%%                                                                             %%%%
                                      %%%%                                                        %%%%                                                                           %%%%                                      %%%%                                                        %%%%                                                                           %%%%                                      %%%%                                                        %%%%                                                                      %%%%                                                                               
                                                                       %%%%                                                         %%%%                                                                                                                                                                                 $                                                       %%%%                                                                                                               $          %%%%                                                                                                    %%%%                                                                                             %%%%
        %%%%               %%%%                                                     %%%%                            %%%%                                   %%%%                                         %%%%                   %%%%         %%%%               %%%%                                                     %%%%                            %%%%                                   %%%%                                         %%%%                   %%%%         %%%%               %%%%                                                     %%%%                            %%%%                                   %%%%                                         %%%%                   %%%%            
P                                                                                      &                                                     &                                                                                                                                                                                                                                                                                                                                                                                                                                                                                                                                                                                           *
###############################################################################################################################################################################################################################################################################################################################################################################################################################################################################################################################################################################################################################################################################################################################################